03 01 01 01 01 01 01 01 01 01 23 01 01 01 01 01 01 01 01 01 04 00 00 00 00 00 00
02 27 27 27 27 27 27 27 27 27 02 27 27 27 27 27 27 27 27 27 02 00 00 00 00 00 00
02 27 03 01 04 27 03 01 04 27 02 27 03 01 04 27 03 01 04 27 02 00 00 00 00 00 00
02 88 02 00 02 27 02 00 02 27 02 27 02 00 02 27 02 00 02 88 02 00 00 00 00 00 00
02 27 06 01 05 27 06 01 05 27 21 27 06 01 05 27 06 01 05 27 02 00 00 00 00 00 00
02 27 27 27 27 27 27 27 27 27 27 27 27 27 27 27 27 27 27 27 02 00 00 00 00 00 00
02 27 03 01 04 27 19 27 03 01 01 01 04 27 19 27 03 01 04 27 02 00 00 00 00 00 00
02 27 06 01 05 27 02 27 06 01 23 01 05 27 02 27 06 01 05 27 02 00 00 00 00 00 00
02 27 27 27 27 27 02 27 27 27 02 27 27 27 02 27 27 27 27 27 02 00 00 00 00 00 00
06 01 01 01 04 27 26 01 20 80 21 80 22 01 24 27 03 01 01 01 05 00 00 00 00 00 00
00 00 00 00 02 27 02 80 80 80 80 80 80 80 02 27 02 00 00 00 00 00 00 00 00 00 00
00 00 00 00 02 27 02 80 03 20 90 22 04 80 02 27 02 00 00 00 00 00 00 00 00 00 00
22 01 01 01 05 27 21 80 02 80 80 80 02 80 21 27 06 01 01 01 20 80 80 80 80 80 80
80 80 80 80 80 27 80 80 02 80 80 80 02 80 80 27 80 80 80 80 80 80 80 00 00 00 00
22 01 01 01 04 27 19 80 06 01 01 01 05 80 19 27 03 01 01 01 20 00 00 00 00 00 00
00 00 00 00 02 27 02 80 80 80 80 80 80 80 02 27 02 00 00 00 00 00 00 00 00 00 00
00 00 00 00 02 27 02 80 03 01 01 01 04 80 02 27 02 00 00 00 00 00 00 00 00 00 00
03 01 01 01 05 27 21 80 06 01 23 01 05 80 21 27 06 01 01 01 04 00 00 00 00 00 00
02 27 27 27 27 27 27 27 27 27 02 27 27 27 27 27 27 27 27 27 02 00 00 00 00 00 00
02 27 22 01 04 27 22 01 20 27 21 27 22 01 20 27 03 01 20 27 02 00 00 00 00 00 00
02 88 27 27 02 27 27 27 27 27 27 27 27 27 27 27 02 27 27 88 02 00 00 00 00 00 00
26 01 04 27 02 27 19 27 03 01 01 01 04 27 19 27 02 27 03 01 24 00 00 00 00 00 00
26 01 05 27 21 27 02 27 06 01 23 01 05 27 02 27 21 27 06 01 24 00 00 00 00 00 00
02 27 27 27 27 27 02 27 27 27 02 27 27 27 02 27 27 27 27 27 02 00 00 00 00 00 00
02 27 22 01 01 01 25 01 20 27 21 27 22 01 25 01 01 01 20 27 02 00 00 00 00 00 00
02 27 27 27 27 27 27 27 27 27 27 27 27 27 27 27 27 27 27 27 02 00 00 00 00 00 00
06 01 01 01 01 01 01 01 01 01 01 01 01 01 01 01 01 01 01 01 05 00 00 00 00 00 00